1111111111111
1001000C00C01
1000011111001
1P0E110000001
1111111111111