1111111111111
1C0E00P0000C1
1111111111111