1111111111111
1C01000C00C01
1000011111001
1P0011C0E0001
1111111111111
